11111111111111111111111111111111111
10000000000000000000000000000000001
10000000000000000000000000000000001
10000000000000000000000000000000001
00000000000000000000000000000000001
10000000000000000000000000000000001
00000000000000000000000000000000000
00000000000000000000000000000000000
00000400000000000004000000000000000
00000000000000000000000000000000000
00000000003000000000000000000000000
00000000000000010000000003000000000
00000000000000000000000000000400000
00000000000000000000000000000000000
00000000000000000000400000000000000
00000000000000000000000300000000000
00000030000000000000000000000000000
00000000000000110000000000000000000
00000000000000000000000000100000000
00000000000000000000000000300000000
00000010000000000000400000000000000
00000000000000001000000000100000000
00000000000000000000100000000000000
00000000001000020000000000000000000
00000000000000220000000000000000000
00000000022222222222002222202222222
22222222222222222222222222222222222
22222222222222222222222222222222222
22222222222222222222222222222222222
22222222222222222222222222222222222


