11111111111111111111111111111111111
10000000000000000000000000000000001
10000000000000000000000000000000001
10000000000000000000000000000000001
00000000000000000000000000000000001
10000000000000000000000000000000001
00000000000000000000000000000000000
00000000000000000000000000000000000
00000400000000000004000000000000000
00000000000000000000000000000000000
00000000000000000000000000000000000
00000000000000010000000000000000000
00000000000000000000000000000400000
00000000000000000000000000000000000
00000000000000000000400000000000000
00000000000000000000000000000003000
00000000000000000000000000000000000
00000000000000110000000000000000000
00000000000000000000000000100000000
00000000000000000000000000000000000
00000010000000000000400000000000000
00000000000000001000000000100000000
00000000000000000000100000000000000
00000000001000000000000000000000000
00000000000000000000000000000000000
22222222222222222222222222222222222
22222222222222222222222222222222222
22222222222222222222222222222222222
22222222222222222222222222222222222
22222222222222222222222222222222222


